00000000090000000003300000000000
00000000000000000333330000009000
09000000000000000003333111900000
00000000000000009000333000000090
00000000000000000000003300000000
00000000000000000000000300000000
00000000000000000000000030000000
00000000333000000000009000000300
00090003333900000000000000000300
000900003331990000000000000000300
00990000000990000000000000003000
00990000000990000000000300003000
00999000000000000000000330033000
00009990000000000000000033330000
00000999000000000000000033330000
00900009900000000000000033330000
00000000990000000000000333330000
00000000000000000000000333300000
00000000000999000000003333300000
00000000000009990000303333000000
00000000000000000000303330000000
00090000000000000003303330000000
00000000333330000333033330000090
00000000003333333330933300000999
00000000000003333333330000099999
00000000900000033333300000999999
00000000000000000333000000999990
00000900000000000000000000099900
00000000000000000000009000000000
00000000000090000000000000000000
00000000000000000000000000000000
00000000000000000000000000000000
